#S######.#
......#..#
.#.##.##.#
.#.#......
##.##.####
....#....#
.#######.#
....#.....
.####.####
........G.

